#############################################################################################
#                                                                                           #
#                                           X                                               ################
#                                                                                                          #
#                                                                             ##############################
#                   O                                                         #
#                                                                             #
#                                                                             #
#                                                                             ################
#########################################################                                    #
                                                        #                                    #
                                                        #         ############################
                                                        #       P #
                                                        #         #
                                                        ###########