*********X
*XXXXX*X*X
*****X*X*X
*XXXXX*X*X
*****X*X*X
*XXX*XXXXX
***X*****X
*XXXXX*X*X
*****X*X*X
XXXXXXXX**